1111111111111111111111111111
1P     11          11     P1
1 1111 11 11111111 11 1111 1
1 1111 11 11111111 11 1111 1
1   11       11       11   1
111 11 11 11 11 11 11 11 111
111 11 11 11 11 11 11 11 111
111 11 11 11 11 11 11 11 111
111    11 11    11 11    111
111 11111 11111111 11111 111
111 11111 11111111 11111 111
1                          1
1 1111 11 W11FF111 11 1111 1
1 1111 11 1FFFFFF1 11 1111 1
1      11 1FBCDEF1 11      1
1 11 1111 1FFFFFF1 1111 11 1
1 11 1111 11111111 1111 11 1
1 11          I         11 1
1 11111 1111 11 1111 11111 1
1 11111 1111 11 1111 11111 1
1            11            1
1 1111111 11111111 1111111 1
1 1111111 11111111 1111111 1
1 11         AK         11 1
1 11 1111 11111111 1111 11 1
1 11 1111 11111111 1111 11 1
1      11 11    11 11      1
1 1111 11 11 11 11 11 1111 1
1 1111 11 11 11 11 11 1111 1
1P     11    11    11     P1
1111111111111111111111111111