1111111111111111111111111111
1                          1
1 1111111 11111111 1111111 1
1 1111111 11111111 1111111 1
1  P   11 11    11 11   P  1
111 11 11 11 11 11 11 11 111
111 11 11 11 11 11 11 11 111
111 11 11 11 11 11 11 11 111
1   11       11       11   1
1 1111 11 11111111 11 1111 1
1 1111 11 11111111 11 1111 1
1      11          11      1
111 11111 111FF111 11111 111
1         1FFFFFF1 11111 111
1 1111111 1FFFFFF1         1
1 1111111 1FFFFFF1 1111111 1
1   11111 11111111 1111111 1
111 11                11   1
111 11 11 11111111 11 11 111
111 11 11 11111111 11 11 111
S      11    11    11      S
111 11111 11 11 11 111111111
111 11111 11 11 11 111111111
1         11    11         1
1 1111 11 11111111 11 1111 1
1 1111 11 11111111 11 1111 1
1 11   11          11   11 1
1 11 1111111 11 1111111 11 1
1 11 1111111 11 1111111 11 1
1   P        11        P   1
1111111111111111111111111111